DIM 6 6
TEMPO 400
PAC 2.p
MON 1.m
XXXXXX
Xooo@X
XoXooX
XoXoXX
XoXooX
XXXXXX